00000000
00000001
00100000
00000001
00000000
03000001
00000000
00000001
14270444
32534144